111111111
1E0000P01
100010C11
111111111