111111111111
1E10P00CCC01
1000C0000011
111111111111