1111111
1E00P01
1010C11
1111111