111111111
1000000P1
1CC000CC1
1E1000001
111111111