111111111
1P1000011
1C0000C11
100000001
111100011
111111011
100111001
100000001
111110001
100100111
1C00E0001
100000001
111111011
1C0000001
100001111
110000001
111111111
