111111111
10E0000C1
100000001
101000P01
111111111