111111111
100000P01
100010011
1E00C0001
111111111