111111111
10E0000C1
100000001
101000001
111111111