111111111
1000000P1
100000001
1E1000001
111111111