11111111
1CE000C1
101000P1
11111111
