111111111111111111
1E0000C0000001C101
100000000000000101
111111110000C00101
1000000C1110001011
1P0011100000000001
111111111111111111
