111111111111111111
1E0000C0000000C001
100000000000000001
111111000000C00101
1000000C1110001011
1P0011111000000001
111111111111111111