11111111111
11C101C11E1
11010100101
1C000000001
11011100111
1100C1P1111
11111111111
