111111111111
1E1000000C01
11100000C0P1
111111111111
